#The Cave|-1|XXXTroedlNettXXX|0,0,0|1|
SSSSSSSSSSSSSSSSSSSSSSSSSSSSSSSSSSSSSSSSSSSSSSSSSSSSSSSSSSSSSSSSSSSSSSSSSSSSSSSSSSSSSSSSSSSSSSSSSSSSSSSSSSSSSSSSSSSSSSSSSSSSSSSSSSSSSSSSSSSSSSSSSSSSSSSSSSSSSSSSSSSSSSSSSSSSSSSSSSSSSSSSSSSSSSSSSSSSSSSSSSSSSSSSSSSSSSSSSSSSSSSSSSSSSSSSSSSSSSSSSSSSSSSSSSSSSSSSSSSSSSSSSSSSSSSSSSSSSSSSSSSSSSSSSSSSSSSSSSSSSSSSSSSSSSSSSSSSSSSSSSSSSSS
SSAAAAAASSSSSSSSSSSSSSSSSSSSSSSSSSSSAAAAAAAASSSSSSSSSSSSSSSSSSSSSSSSSSSSSSSSSSSSSSSSSSSSSSSSSSSSSSSSSSSSSSSSSSSSSSSSSSSSSSSSSSSSSSSSSSSSSSSSSSSSSSSSSSSSSSSSSSSSSSSSSSAAAAACAAAAAAAAAAAAAAAAAAAAAAAAAASSSSSSSSSSSSSSSSSSSSAAAAAAAAAAAAAAAAAAAAAAAAAAAAAAAAAAAAASSSSSSSSSSSSSSSSSSSSSSSSSSSSSSSSSSSSSSSSSSSSSSSSSSSSAAAAAAAAAAAAAAAAAASS
SSPAAAAAASSSSSSSSSSSSSSSSSSSSSSSSAACCCCCCAAAASSSSSSSSSSSSSSSSSSSSSSSSSSSSSSSSSSSSSSSSSSSSSSSSSSSSSSSSSSSSSSSSSSSSSSSSSSSSSSSSSSSSSSSSSSSSSSSSSSSSSSSSSSSSSSSSSSSSAAAAAAAAAAAAAAAAAAAAAAAAAAAAAAAAAAAAAASSSSSSSIAAAAAAAAAAAACAAAAAAAAAAAAAAAAAAAAAAAAAAAAAAAAAAAAAAAAAAASSSSSSSSSSSSSSSSSSSSSSSSSSSSSSSSSSSSSSSSAAAAAAAAAAAAAAAZAAAASSSS
SSSAAAAAAIAAASAAAAASSSSSSSSSSSSSSSAAAAAASSSSSSSSSSSSSSSSSSSSSSSSSSSSSSSSSSSSSSSSSSSSSSSSSSSSSSSSSSSSSSSSSSSSSSSSSSSSSSSSSSSSSSSSSSSSSSSSSSSSSSSSSSSSSSSSSSSSAAAAAAAAAAAAAAAAAASSSSSSSSSSSSSSAAAAAAAAAAAAAAAAAAAAAAAAAAAAAAAAAAAAAAAAAAAAAASSSSSSSSSSSAAAAAAAAAAAAAAAAASSSSSSSSSSSSSSSSSSSSSSSSSSSSSSSSSSSSSAAACAAAAAEAAAAAASSSSSSSSSSSS
SSSSSAAAAAAAASSSSSSSSSdddAAAAAASSSSSSSSSSSSSSSSSSSSSSSSSSSSSSSSSSSSSSSSSSSSSSSSSSSSSSSSSSSSSSSSSSSSSSSSSSSSSSSSSSSSSSSSSSSSSSSSSSSSSSSSSSSSSSSSSSSSSSSSAAAAAAEAAAAAAAAAASSSSSSSSSSSSSSSSSSSSSSSSSSSAAAAAAAAAAAAAAAAAAAAASSSSSSSSSSSSSSSSSSSSSSSSSSSSSSSSSSSSAAAAAAAAAAAAASSSSSSSSSSSSSSSSSSSSSSSSSSSSSSSSAAAAAAAAAAAAAAASSSSSSSSSSSSSSS
SSSSSSAAAAEAAAAAAAddAAAAAAAAAAAAAAAAIASSSSSSSSSSSSSSSSSSSSSSSSSSSSSSSSSSSSSSSSSSSSSSSSSSSSSSSSSSSSSSSSSSSSSSSSSSSSSSSSSSSSSSSSSSSSSSSSSSSSSSSSSSSSAAAAAAAAAAAAAAAAASSSSSSSSSSSSSSSSSSSSSSSSSSSSSSSSSSSSSSSSSSSSSSSSSSSSSSSSSSSSSSSSSSSSSSSSSSSSSSSSSSSSSSSSSSSSAAAAAAAAAAAAASSSSSSSSSSSSSSSSSSSSSSSSSSAAAAAAAAAEAAAAAASSSSSSSSSSSSSSSSS
SSSSSSSSAAAAAAAAAAAAdddAAAAEAAAAAAAAAAAAAAAASSSSSSSSSSSSSSSSSSSSSSSSSSSSSSSSSSSSSSSSSSSSSSSSSSSSSSSSSSSSSSSSSSSSSSSSSSSSSSSSSSSSSSSSSSSSAAAAAAAAAAAAAAAAAAASSSSSSSSSSSSSSSSSSSSSSSSSSSSSSSSSSSSSSSSSSSSSSSSSSSSSSSSSSSSSSSSSSSSSSSSSSSSSSSSSSSSSSSSSSSSSSSSSSSSSSSSAAAAAAAAAASSSSSSSSSSSSSSSSSSSSSAAAAAAAAAAAAAAAAAAAASSSSSSSSSSSSSSSSS
SSSSSSSSSSSSSAACAAAAAAAdAAAAAAAAAAAAAAAAAAAAAAASSSSSSSSSSSSSSSSSSSSSSSSSSSSSSSSSSSSSSSSSSSSSSSSSSSSSSSSSSSSSSSSSSSSSSSSSSSSSSSSSSSSSSSSSAAAAAAAAACAAAAAAAAAAAAASSSSSSSSSSSSSSSSSSSSSSSSSSSSSSSSSSSSSSSSSSSSSSSSSSSSSSSSSSSSSSSSSSSSSSSSSSSSSSSSSSSSSSSSSSSSSSSSSSSSAAAAAAAACAAAAAAAAAaaaaaaaaaaaaaAAAAAAAAAAAAAAAAAASSSSSSSSSSSSSSSSSSS
SSSSSSSSSSAAAAAAAAAACAAAASSSSSSSSSSSSAAAAAAAASSSSSSSSSSSSSSSSSSSSSSSSSSSSSSSSSSSSSSSSSSSAAAAAAAAAAeAAAAAAAAASSSSSSSSSSSSSSSSSSSSSSSSSSAAAAAEAAAAAAAAAAASSSSSSSSSSSSSSSSSSSSSSSSSSSSSSSSSSSSSSSSSSSSSSSSSSSSSSSSSSSSSSSSSSSSSSSSSSSSSSSSSSSSSSSSSSSSSSSSSSSSSSSSSSSSSSAAAAAAAAAAAAAAAAAAAAAAAAAAAAAAAAAAAAAAAAAASSSSSSSSSSSSSSSSSSSSSSSS
SSSSSSSSAAAAAAAAAAAAAAAAASSSSSSSSSSSSSSAAAAAAAAASSSSSSSSSSSSSSSSSSSSSSSSSSSSSSSSSSSSSSSAAAASSSSSSSSSSSSSSAAAACCCCCCCCCCCCCCCCAAAAAAAAAAAAAAAAAAAAAAASSSSSSSSSSSSSSSSSSSSSSSSSSSSSSSSSSSSSSSSSSSSSSSSSSSSSSSSSSSSSSSSSSSSSSSSSSSSSSSSSSSSSSSSSSSSSSSSSSSSSSSSSSSSSSSSSSSAAAAASSSSAAAAASSSSSSAAAASSSSSSSSSSSAAAASSSSSSSSSSSSSSSSSSSSSSSSS
SSSSSSSSSSSSSSSSSSSSASSAAAAAAASSSSSSSSSSSSSSSAACAAASSSSSSSSSSSSSSSSSSSSSSSSSSSSSSSSSSAAASSSSSSSSSSSSSSSSSSSSSSSSSSSSSSSSSSSSSSSSSSSSSSAAAAAAAAAAAAAAAAASSSSSSSSSSSSSSSSSSSSSSSSSSSSSSSSSSSSSSSSSSSSSSSSSSSSSSSSSSSSSSSSSSSSSSSSSSSSSSSSSSSSSSSSSSSSSSSSSSSSSSSSSSSSSSSSSSSSSSwwwwwwwwwwwwwwwwwwwwwwwwwSSSSSSAAAASSSSSSSSSSSSSSSSSSSSSSS
SSSSSSSSSSSSSSSSSSSSASSSSSSAAAAAAASSSSSSSSSSSSAAAAASSSSSSSSSSSSSSSSSSSSSSSSSSSSSSSAAASSSSSSSSSSSSSSSSSSSSSSSSSSSSSSSSSSSSSSSSSSSSAAAAAAAAAAAAASSSSSSAASSSSSSSSSSSSSSSSSSSSSSSSSSSSSSSSSSSSSSSSSSSSSSSSSSSSSSSSSSSSSSSSSSSSSSSSSSSSSSSSSSSSSSSSSSSSSSSSSSSSSSSSSSSSSSSSSSSSWWWWWWWWWWWWWWWWWWWWWWWWWSSSSSAAAASSSSSSSSSSSSSSSSSSSSSSSSSSS
SSSSSSSSSSSSSSSSSSSSASSSSSSSSSSSSSSSSSSSSSSSSSSSAAAAASSSSSSSSSSSSSSSSSSSSSSSSSSSSAAASSSSSSSSSSSSSSSSSSSSSSSSSSSSSSSSSSSSSSSSSAAAAAAAAAAAAASSSSSSSSSSAASSSSSSSSSSSSSSSSSSSSSSSSSSSSSSSSSSSSSSSSSSSSSSSAAAAAAAAAASSSSSSSSSSSSSSSSSSSSSSSSSSSSSSSSSSSSSSSSSSSSSSSSSSSSSSSSSSSSSSSSSSSSSSSSSSSSSSSSSSSSSSSSAAAASSSSSSSSSSSSSSSSSSSSSSSSSSSS
SSSSSAaaaaaAASSSSSSAAAAAAAaaaaaAAAAAAAAAAAASSSSSSAAAAASSSSSSSAAAddddAAASSSSSSAAAAAASSSAAASSSSSSSSSSSSSSSSSSSSAAAAAAAAAAAAAAAAAAAAAAAAAAAAASSSSSSSSSSAASSSSSSSSSSSSSSSSSSSSSSSSAAAASSSSSSSSSSSSSSSSSSSAASSSSSSSAAASSSSSSSSSAAAASSSSSSSSSSSAAAAASSSSSSSSSSSSSSSSSSSSSSSSSSSAAAAAAAAAAAAAAeAAAAAAAAAAAAeAAAAASSSSSSSSSSSSSSSSSSSSSSSSSSSSS
SSAAAAAAAAAAAAAAAAAAAAAAAAAAAAAAAAAAAAAAAAAASSSSAAAAAAAAAAAAAAAAAAAAAAAAAAAAddddddSAAAAAAAAAAAAAAAAAAAAAAAAAAAAAEAAAAAAAAAAAAAAAASSSSSSSSSSSSSSSSSSSAASSSSSSSSSSSSSSSSSSAAAAAAAAAAAAAAAAAeAAAAAACAAAAAAAAAAAAAAAAAAAAAAAeAAAAAAAAAAAAAAAAAeAAAAAAAAAAAAAAAAAAAeAAAAAAAAAAAAAAAASSSSSSSSSSSSSSSSSSSSSSSSSSSSSSSSSSSSSSSSSSSSSSSSSSSSSSSS
SAA1AEAAAAASISAAAAEAAACAAAAAAAAAAAASSSSASSSSSSSAAAAAAAAAAAAAAAAEAAAAAAAAAAAAAAAAAAAAAAAAAAAAAAAAAAAAAAAAAAAAAAAAAAAAAASSSSSSSSSSSSSSSSSSSSSSSSSSAAAAAAAAAIAAAAAAAAAAAAAAAAASSSSSAASSSSSSSSSSSSAAAASSSSSSSSSSSSSSSSSSSSSSSSSSAAASSSSSSAAAASSSSSSSSSSSSSSSSSSSSSSSSSSSSSSSSSSSSSSSSSSSSSSSSSSSSSSSSSSSSSSSSSSSSSSSSSSSSSSSSSSSSSSSSSSSSSS
SSAAAAAAAeeAAAAAAAAAAAAAASAASSSSSSSSSSSASAAAAAAAASSSSSSAAAAAAAAAAAASSSSAAAAAAAAAAAAAAASSSSSSSAAAASSAAASSSSSSSSSSSSSSSSSSSSSSSSSSSSSSSSSSSSSSSSSAAAAAAAAAAAAAAAAAAAAAAAAAASSSSSSSSAASSSSSSSAAAAASSSSSSSSSSSSSSSSSSSSSSSSSSSSSSAA2AAAAASSSSSSSSSSSSSSSSSSSSSSSSSSSSSSSSSSSSSSSSSSSSSSSSSSSSSSSSSSSSSSSSSSSSSSSSSSSSSSSSSSSSSSSSSSSSSSSSSS
SSSSSSSAAAAAAAASSSSSSSSSSSSSSSSSSSSSSSSAAAAAAAAASwwwwwwwwwSSSSSwwwwwwwwwwwwwwwSSSSSwwwwwwwwwwwwwwwwwwwSSSSSSSSSSSSSSSSSSSSSSSSSSSSSSSSSSSSSSSSSSAeeeeeAAAAAAAAAAASSSSSSSSSSSSSSSSSAAAAAAAASSSSSSSSSSSSSSSSSSSSSSSSSSSSSSSSSSSSSSSSSSSSSSSSSSSSSSSSSSSSSSSSSSSSSSSSSSSSSSSSSSSSSSSSSSSSSSSSSSSSSSSSSSSSSSSSSSSSSSSSSSSSSSSSSSSSSSSSSSSSS
SSSSSSSSSSSSSSSSSSSSSSSSSSSSSSSSSSSSSSSAAASSSSSSSWWWWWWWWWWWWWWWWWWWWWWWWWWWWWWWWWWWWWWWWWWWWWWWWWSSSSSSSSSSSSSSSSSSSSSSSSSSSSSSSSSSSSSSSSSSSSSSSSSSSSSSSSSSSSSSSSSSSSSSSSSSSSSSSSSSSSSSSSSSSSSSSSSSSSSSSSSSSSSSSSSSSSSSSSSSSSSSSSSSSSSSSSSSSSSSSSSSSSSSSSSSSSSSSSSSSSSSSSSSSSSSSSSSSSSSSSSSSSSSSSSSSSSSSSSSSSSSSSSSSSSSSSSSSSSSSSSSSSS
SSSSSSSSSSSSSSSSSSSSSSSSSSSSSSSSSSSSSSSSSSSSSSSSSSSSSSSSSSSSSSSSSSSSSSSSSSSSSSSSSSSSSSSSSSSSSSSSSSSSSSSSSSSSSSSSSSSSSSSSSSSSSSSSSSSSSSSSSSSSSSSSSSSSSSSSSSSSSSSSSSSSSSSSSSSSSSSSSSSSSSSSSSSSSSSSSSSSSSSSSSSSSSSSSSSSSSSSSSSSSSSSSSSSSSSSSSSSSSSSSSSSSSSSSSSSSSSSSSSSSSSSSSSSSSSSSSSSSSSSSSSSSSSSSSSSSSSSSSSSSSSSSSSSSSSSSSSSSSSSSSSSSSS