SAAAAAAAAAAAAAAAAAAAAAAAAAAAAAAAAAAAAAAS
SAAAAAAAAAAAAAAAAAAAAAAAAAAAAAAAAAAAAAAS
SAAAAAAAAAAAAAAAAAAAAAAAAAAAAAAAAAAAAAAS
SAAAAAAAAAAAAAAAAAAAAAAAAAAAAAAAAAAAAAAS
SAAAAAAAAAAAAAAAAAAAAAAAAAAAAAAAAAAAAAAS
SAAAAAAAAAAAAAAAAAAAAAAAAAAAAAAAAAAAAAAS
SAAAAAAAAAAAAAAAAAAAAAAAAAAAAAAAAAAAAAAS
SAAAAAAAAAAAAAAAAAAAAAAAAAAAAAAAAAAAAAAS
SAAAAAAAAAAAADAAAAAAAAAAAAAAAAAAAAAAAAAS
SIIIIIIIAAAAAAAAAAAAAAAAAAAAAAAAAAAAAAAS
SAAAAAAAAAAADDAAAAAAAAAAAAAAAAAAAAAAAAAS
SAAAAAAAAAAAAAAAAAAAAAAAAAAAAAAAAAAAAAAS
SDDDDDDDDAAAAAAAAAAAAAAAAAAAAAAAAAAAAAAS
SAAAAPAAAAADDDAAAAAAAAAAAAAAAAAAAAAAAAAS
SSSSSSSSSSSSSSSSSSSSSSSSSSSSSSSSSSSSSSSS