SAAAAAAAAAAAAAAAAAAS
SAAAAAAAAAAAAAAAAAAS
SAAAAAAAAAAAAAAAAAAS
SAAAAAAAAAAAAAAAAAAS
SAAAAAAAAAAAAAAAAAAS
SAAAAAAAAAAAAAAAAAAS
SAAAAAAAAAAAAAAAAAAS
SAAAAAAAAAAAAAAAAAAS
SAAAAAAAAAAAADAAAAAS
SIIIIIIIAAAAAAAAAAAS
SAAAAAAAAAAADDAAAAAS
SAAAAAAAAAAAAAAAAAAS
SDDDDDDDDAAAAAAAAAAS
SAAAAPAAAAADDDAAAAAS
SSSSSSSSSSSSSSSSSSSS